lencse - lentils
amin - where
leszokom - I (will) quit
ilyenkor - at this time
fogadalmak - resolutions
barmivel - with anything
tettek - they did/they have done
latogat - to visit
verseny - contest
elég - enough
arra gondolni - to think about
csökkent valamit - to reduce something
fürdes - bathing swimming
segít valakinek - help someone
változtatni - to change
mindennapi szokásaink - our everyday habits
sikeres - successful
megoszt valami - to share something
ezelőtt - ago
azoknak - for those
milyen sokat - how much
több mint - more than
mögöttünk - behind us
köt ki - end up (in)...
annyira - so/quite
elutazhattak - they could go/they could leave for
szervezem - I organize
szívesen - gladly
konkrét - specific
sokszor - often
tyúk láb - chicken feet
műsor - show
békeszerződés - peace treaty
próbálunk - we try
csillag - star
értékeljük - (we) appreciate
magunkat - ourselves
ellen - against
fegyver - weapon
megoldas - solution
jobban érezzük magunkat - we feel better
része - part of it
mindannyian - all of us
láthatjak - they can see
kerek - round/circular
edzenek - they train
hisszük - we believe
boldogság - happiness
felmelegszik - to warm up
keveset + verb - not enough of something
lefogyok - I will lose weight
történik - to happen
viszont - on the other hand/however
furcsa - strange
közösségi - community
ötlet - idea
szilveszter ejjel - on New Year's Eve
hamar - soon/early
takarítani - to clean
szükségük - they need
hasonmas - impersonator
jövöben - in the future
élvezem - i enjoy
babona - superstition
látnival - sights/sites
lássuk! - let's see
majd - then
égen - in the sky
nagydij - prize
fog - will (certainty)
fiatal - young one/youngster
...elején - beginning of...
komolyan - seriously
átvenni - take/collect
például - for example
hangulat - mood
döntés - decision
vagyis - that is
ételpazarlás - food waste
minket - us
megtiszteltetés - honorable
idószak - period/phase
bezárják - they close
kitalál valamit - to invent/to find something
túrázni - hiking
tyúkhúsleves - chicken (meat) soup
figyelni - to pay attention
kidobni - to thrown out
segítenek másoknak - they help others
elvisz - to take away
szemet - trash
közepén - in the middle of
menedék - refuge/shelter
igazságtalan - unjust/unfair
térképen - on a map
vezettem - I hosted
pontosan - exactly
nagy - O - the one
később - later/later on
ima - prayer
vett részt - participated
kockasajt - cheese cube
akarunk - we want/we desire
nyujt - to provide
keresztül - through
gyűjtenek - they collect/earn/amass
formájú - round
számomra - for me
megijedt - frightened
sekély - shallow
igy - "like this"
elkezdődött - start/begin
népszerű - popular
szerencsés - lucky
azonban - however
csökkenteni - to reduce
felhasználó - user
segítségével - with the help of.../using...
eleget + verb - do enough of something
háromszög alakú - triangular-shaped
indul - leave for
munkahely - workplace
lakas - apartment
sikerűl - succeed/manage
megtalálni - to find (sth)
érezzük - we feel it
sikeres valamiben - successful in something
költenek - they spend
jelöltek - ...was nominated
ezért - therefore/so
hosszú távon - long-term
árulnak - they sell
arra - to that (about it)
betartani - to abide by/to keep
tehetséges - talented
töltök - I spend
vele - with it
szokások - customs
azt gondoljuk - we think
szerencsét hoz - bring good luck
bánok - I manage
tesz - to do/to practice
lenyűgöz - amazing
messze - far (away)
gomboc - dumpling
beletesszük - we put into/add
pedig - while/meanwhile
elmondhatják - they can tell
másokra - to others
majdnem - almost
korcsolyázni - ice skating
legtobb ember - a lot of people
világszerte - worldwide
először - firstly
bármilyen - any
malac - pork
szeretlek - i love you
maradnak - they remain/stay
már - only
rengeteg - plenty
gyógyszer - medicine
jótékonykodnak - (they) do charity
reklám - promo/publicity/advert
borso - peas
fiatalság - youth
olyan - such a..., a kind of...
bár - however/although
legutobb - last time
tesznek minket - they make us...
weboldal - website
másoknak - for others
megenné - would eat (it)
vitorlázni - sailing
más - different
nyertek - they won
nem szabad - not allowed
a/az ... miatt - because of...
megoszthatják - they can share
foglalkoz - deals with (is engaged/is occupied with)
kukába - to the trash bin
természet - nature
mozog - to move
nemzetközi - international
